XXXXXXXXXBXX XXX
XXXXXXXXX XX XXX
XXXXXXXXX    XXX
XXXXXXXXXX X XXX 
XXXXXXXXXX   XXX
XXXXXXXXXXXX    
XXXXXXXXXXXX XXX
             XXX
XX XXXXXXXXX XXX
XX XXXXXXXXX XXX             
XX XXXXXXXXX XXX
XX XXXXXXXXX XXX
XX  XX XXXXX XXX
XX XXX XXXXXXXXX        
XX XXXXXXXXXXXXX             
XXAXXXXXXXXXXXXX                          